
######################
#------#------#------#
#------#-E----#---E--#
#------###----#------#
#------#-------------#
#------#-------------#
###--###------#------#
#------#---E--#------#
#------#------###--###
#--E---#------#------#
#------#------#------#
#------###--###------#
#-------------#------#
#---------E---#---E--#
#-S----#------#------#
######################