
######################
#--E---#--E---#------#
#------#------#---E--#
#------###--###------#
#------#------#------#
#-S-------E----------#
#------#------#------#
######################