
######################
#-----#-------#------#
#-----#-------#------#
#---------##--####---#
#---------##--#--#---#
#---#-----##--#--#---#
#---#-----##--#--#---#
########--##--#--#---#
#------#--##--#--#---#
#------#------#--#---#
#--##---------#------#
#--##---------#------#
#--##------######--###
#------#-------------#
#------#-------------#
######################